gradient boost
[[3427    1]
 [   0 1072]]
              precision    recall  f1-score   support

           0       1.00      1.00      1.00      3428
           1       1.00      1.00      1.00      1072

    accuracy                           1.00      4500
   macro avg       1.00      1.00      1.00      4500
weighted avg       1.00      1.00      1.00      4500

0.9997777777777778
       actual  predicted
6723        0          0
6473        0          0
4679        0          0
862         1          1
7286        0          0
8127        0          0
3017        0          0
3087        0          0
6425        0          0
2250        0          0
542         1          1
9293        0          0
11723       0          0
4923        0          0
12070       1          1
10602       0          0
11874       0          0
11118       0          0
10778       0          0
8054        0          0
2312        0          0
14768       1          1
1889        1          1
8990        0          0
169         1          1
1795        1          1
14303       1          1
3919        0          0
14018       0          0
3728        0          0
...       ...        ...
13646       0          0
7224        0          0
5688        0          0
13525       0          0
14005       0          0
2685        0          0
9383        0          0
10687       0          0
13897       0          0
911         1          1
8131        0          0
12731       1          1
7075        0          0
1345        1          1
1444        1          1
6196        0          0
3499        0          0
6790        0          0
7309        0          0
12532       1          1
2422        0          0
7635        0          0
2732        0          0
80          1          1
4217        0          0
13388       0          0
10463       0          0
5331        0          0
7499        0          0
11796       0          0

[4500 rows x 2 columns]
